50,1,1,

11,11,11,10,10,10,11,10,01,10,
10,10,10,10,10,10,10,02,10,10,
04,10,10,10,10,10,06,10,10,10,
09,10,10,10,08,10,10,10,10,10,
08,09,10,10,10,10,10,11,11,11,
