52,1,1,

08,08,08,02,01,02,03,02,01,02,
02,11,02,02,02,02,02,03,02,02,
13,02,02,02,02,02,12,02,02,02,
10,02,02,02,09,02,02,02,02,02,
09,10,02,02,02,02,02,08,08,08,
02,02,
