51,1,1,

07,07,07,01,01,01,01,01,02,01,
01,10,01,01,01,01,01,03,01,01,
12,01,01,01,01,01,11,01,01,01,
09,01,01,01,08,01,01,01,01,01,
08,09,01,01,01,01,01,07,07,07,
01,
