62,1,1,

01,02,02,03,02,11,02,12,02,02,
02,01,02,02,01,02,02,15,16,17,
18,19,18,19,18,21,18,19,18,19,
20,19,18,19,18,53,35,34,35,34,
35,40,35,34,41,35,34,83,54,47,
46,47,46,47,46,47,46,47,46,47,
46,47,
