62,1,1,

01,02,01,03,01,05,01,01,11,01,
01,02,01,01,15,16,17,18,19,18,
19,18,21,18,19,18,19,20,19,18,
53,35,34,35,34,35,34,37,34,35,
34,35,36,35,34,35,34,55,46,47,
46,47,46,47,46,47,46,47,46,47,
46,47,
