52,1,1,

08,08,08,02,01,08,08,08,08,08,
10,11,12,08,15,16,17,18,19,18,
19,18,21,18,19,18,19,20,19,18,
19,18,19,18,21,18,19,18,19,20,
19,18,19,18,19,18,21,18,19,18,
19,18,
